year,state,house,senate,pres,pres & senate,pres & sen & house
1976,AL,356,0,122,122,478
1976,AK,37,0,71,71,108
1976,AZ,192105,152,96,143,192248
1976,AR,96,0,52,52,148
1976,CA,155631,574,1323,1897,157528
1976,CO,5097,0,142,142,5239
1976,CT,529,96,338,296,825
1976,DE,479,132,321,283,762
1976,FL,761,61,328,288,1049
1976,GA,933,0,46,46,979
1976,HI,410,123,806,855,1265
1976,ID,3098,0,69,69,3167
1976,IL,214662,0,1148,1148,215810
1976,IN,6338,84,218,200,6538
1976,IA,3058,0,4143,4143,7201
1976,KS,2028,0,221,221,2249
1976,KY,436,0,233,233,669
1976,LA,985,0,296,296,1281
1976,ME,135,77,7889,7966,8101
1976,MD,913,90,281,251,1164
1976,MA,863,39,102,98,961
1976,MI,194486,306,320,284,194770
1976,MN,372,37,125,119,491
1976,MS,164,16,1226,1242,1406
1976,MO,1642,111,509,419,2061
1976,MT,213,55,224,205,418
1976,NE,244,294,76,268,512
1976,NV,24,50,410,349,373
1976,NH,116,0,143,143,259
1976,NJ,2039,70,1005,1075,3114
1976,NM,73,113,835,820,893
1976,NY,217721,152,271,243,217964
1976,NC,1463,0,147,147,1610
1976,ND,59,62,289,257,316
1976,OH,12489,648,4110456,4110456,4122945
1976,OK,1318,0,2665,2665,3983
1976,OR,258,0,1029876,1029876,1030134
1976,PA,34281,307,753,619,34900
1976,RI,89,101,143,135,224
1976,SC,954,0,123,123,1077
1976,SD,65,0,1828,1828,1893
1976,TN,377,317,124,288,665
1976,TX,194058,110,603,480,194538
1976,UT,217,127,55,125,342
1976,VT,45,380,131,327,372
1976,VA,4164,84,2200,2284,6448
1976,WA,218180,33,470,392,218572
1976,WV,330,16,99,95,425
1976,WI,848,35,1472,1507,2355
1976,WY,125,179,81,167,292
1976,DC,0,0,24,24,24
1976,USA,1475364,5031,5174928,5175782,6651146
1978,AL,397,18,0,18,415
1978,AK,148,30,0,30,178
1978,AR,894,26,0,26,920
1978,CO,141934,86,0,86,142020
1978,DE,93,94,0,94,187
1978,GA,399,24,0,24,423
1978,ID,189,42,0,42,231
1978,IL,179404,211,0,211,179615
1978,IA,615,591,0,591,1206
1978,KS,620,141,0,141,761
1978,KY,576,65,0,65,641
1978,LA,131012,16,0,16,131028
1978,ME,225,70,0,70,295
1978,MA,561,159,0,159,720
1978,MI,25895,418,0,418,26313
1978,MN,801,98,0,98,899
1978,MS,208,119,0,119,327
1978,MT,226,142,0,142,368
1978,NE,506,44,0,44,550
1978,NH,106,978,0,978,1084
1978,NJ,2314,132,0,132,2446
1978,NM,79,247,0,247,326
1978,NC,780,182,0,182,962
1978,OK,400,48,0,48,448
1978,OR,253,67,0,67,320
1978,RI,403,31,0,31,434
1978,SC,521,142,0,142,663
1978,SD,129360,47,0,47,129407
1978,TN,320,105,0,105,425
1978,TX,7792,2312540,0,2312540,2320332
1978,VA,1051,1222256,0,1222256,1223307
1978,WV,313,4871,0,4871,5184
1978,WY,92,65,0,65,157
1978,AZ,349,0,0,0,349
1978,CA,4447,0,0,0,4447
1978,CT,736,0,0,0,736
1978,FL,1626,0,0,0,1626
1978,HI,51,0,0,0,51
1978,IN,1582,0,0,0,1582
1978,MD,1061,0,0,0,1061
1978,MO,627,0,0,0,627
1978,NV,33,0,0,0,33
1978,NY,7370,0,0,0,7370
1978,ND,43,0,0,0,43
1978,OH,3587,0,0,0,3587
1978,PA,9254,0,0,0,9254
1978,UT,423,0,0,0,423
1978,VT,28,0,0,0,28
1978,WA,1577,0,0,0,1577
1978,WI,695,0,0,0,695
1978,DC,0,0,0,0,0
1978,USA,661976,3544105,0,3544105,4206081
1980,AL,623,620,2313,2933,3556
1980,AK,33,214,56,199,232
1980,AZ,227,3526,48,3574,3801
1980,AR,75,87,837582,837582,837657
1980,CA,157293,82,95,91,157384
1980,CO,394,1531,66,1597,1991
1980,CT,18294,119,170,158,18452
1980,DE,65,0,901,901,966
1980,FL,860,569,93,479,1339
1980,GA,370,1383,108,1491,1861
1980,HI,45,26,1209,1235,1280
1980,ID,315,4672,38,4710,5025
1980,IL,8097,119,209,192,8289
1980,IN,198556,220,86,205,198761
1980,IA,1244,209,127,198,1442
1980,KS,467,57,64,62,529
1980,KY,313,52,2071,2123,2436
1980,LA,250,84,317,279,529
1980,ME,69,0,561,561,630
1980,MD,878,48,658,515,1393
1980,MA,1307,0,2524090,2524090,2525397
1980,MI,4317,0,261,261,4578
1980,MN,1046,0,461,461,1507
1980,MS,328,0,2235,2235,2563
1980,MO,680,413,247,357,1037
1980,MT,156,0,65,65,221
1980,NE,226,0,40,40,266
1980,NV,36,74,43,72,108
1980,NH,129,417,53,363,492
1980,NJ,5796,0,120,120,5916
1980,NM,1552,0,87,87,1639
1980,NY,180185,298,1859,2157,182342
1980,NC,2878,1797665,1029,1798694,1801572
1980,ND,112,0,41,41,153
1980,OH,1534,39,153,144,1678
1980,OK,1536,164,62,161,1697
1980,OR,2591,205,169,195,2786
1980,PA,177840,845,236,975,178815
1980,RI,197,0,155,155,352
1980,SC,1353,38,2531,2569,3922
1980,SD,145,84,54,81,226
1980,TN,262,0,1617616,1617616,1617878
1980,TX,3534,0,116,116,3650
1980,UT,472,32,30,33,505
1980,VT,24,2258,287,2545,2569
1980,VA,197107,0,126,126,197233
1980,WA,1068,198,130,184,1252
1980,WV,547,0,394,394,941
1980,WI,1722,1259,374,1633,3355
1980,WY,42,0,45,45,87
1980,DC,0,0,25,25,25
1980,USA,977190,1817607,4999906,6815125,7792315
1982,AZ,2086,96,0,96,2182
1982,CA,4270,249,0,249,4519
1982,CT,6168,414,0,414,6582
1982,DE,282,148,0,148,430
1982,FL,2062,67,0,67,2129
1982,HI,39,25,0,25,64
1982,IN,2075,200,0,200,2275
1982,ME,910,73,0,73,983
1982,MD,592,58,0,58,650
1982,MA,445,70,0,70,515
1982,MI,1485,94,0,94,1579
1982,MN,217758,283,0,283,218041
1982,MS,1471,55,0,55,1526
1982,MO,5026,1439,0,1439,6465
1982,MT,242,126,0,126,368
1982,NE,165,41,0,41,206
1982,NV,219,863,0,863,1082
1982,NJ,1135,598,0,598,1733
1982,NM,509,221,0,221,730
1982,NY,20960,46,0,46,21006
1982,ND,36,55,0,55,91
1982,OH,1882,103,0,103,1985
1982,PA,165142,79,0,79,165221
1982,RI,213,868,0,868,1081
1982,TN,4423,66,0,66,4489
1982,TX,140379,88,0,88,140467
1982,UT,307,94,0,94,401
1982,VT,34,635,0,635,669
1982,VA,16195,875,0,875,17070
1982,WA,493,35,0,35,528
1982,WV,448,41,0,41,489
1982,WI,546,53,0,53,599
1982,WY,37,120,0,120,157
1982,AL,8184,0,0,0,8184
1982,AK,37,0,0,0,37
1982,AR,367,0,0,0,367
1982,CO,503,0,0,0,503
1982,GA,469,0,0,0,469
1982,ID,618,0,0,0,618
1982,IL,27330,0,0,0,27330
1982,IA,516,0,0,0,516
1982,KS,299,0,0,0,299
1982,KY,464,0,0,0,464
1982,LA,128,0,0,0,128
1982,NH,195,0,0,0,195
1982,NC,12787,0,0,0,12787
1982,OK,382,0,0,0,382
1982,OR,1324,0,0,0,1324
1982,SC,742,0,0,0,742
1982,SD,615,0,0,0,615
1982,DC,0,0,0,0,0
1982,USA,652994,8278,0,8278,661272
1984,AL,1338,60,71,69,1407
1984,AK,120,37,43,42,162
1984,AZ,832,0,46,46,878
1984,AR,355,109,71,105,460
1984,CA,2418,0,98,98,2516
1984,CO,466,53,55,54,520
1984,CT,844,0,72,72,916
1984,DE,93,78,80,78,171
1984,FL,921,0,51,51,972
1984,GA,630,26,77,75,705
1984,HI,46,0,143,143,189
1984,ID,202441,34,34,34,202475
1984,IL,234174,1249,125,1374,235548
1984,IN,235035,0,66,66,235101
1984,IA,1992,137,226,206,2198
1984,KS,277,29,47,46,323
1984,KY,452,1292407,77,1292484,1292936
1984,LA,128,16,70,86,214
1984,ME,87,33,72,69,156
1984,MD,1049,0,314,314,1363
1984,MA,670,161,710,546,1216
1984,MI,210985,384,83,339,211324
1984,MN,510,95,2084449,2084449,2084959
1984,MS,1556,72,64,70,1626
1984,MO,1014,0,79,79,1093
1984,MT,95,98,71,96,191
1984,NE,109,465,37,396,505
1984,NV,151,0,46,46,197
1984,NH,117,89,41,87,204
1984,NJ,1033,54,76,73,1106
1984,NM,151,36,77,75,226
1984,NY,3234,0,313,313,3547
1984,NC,227817,474,66,395,228212
1984,ND,27,0,51,51,78
1984,OH,1175,0,85,85,1260
1984,OK,588,30,41,41,629
1984,OR,704,47,132,125,829
1984,PA,251420,0,227,227,251647
1984,RI,86,35,507,417,503
1984,SC,366,45,56,55,421
1984,SD,108,32,59,58,166
1984,TN,581,58,98,94,675
1984,TX,3020,93,57,91,3111
1984,UT,213861,0,31,31,213892
1984,VT,40,0,93,93,133
1984,VA,1131,39,62,61,1192
1984,WA,461,0,119,119,580
1984,WV,412,441,155,379,791
1984,WI,468,0,179,179,647
1984,WY,32,28,37,36,68
1984,DC,0,0,22,22,22
1984,USA,1605620,1297044,2089961,3384640,4990260
1986,AL,259,1211897,0,1211897,1212156
1986,AK,104,164,0,164,268
1986,AZ,191,75,0,75,266
1986,AR,136,64,0,64,200
1986,CA,2040,1966,0,1966,4006
1986,CO,1333,1676,0,1676,3009
1986,CT,481,52,0,52,533
1986,FL,527,173,0,173,700
1986,GA,555,1278,0,1278,1833
1986,HI,102,33,0,33,135
1986,ID,237,616,0,616,853
1986,IL,21304,50,0,50,21354
1986,IN,153686,71,0,71,153757
1986,IA,1633,48,0,48,1681
1986,KS,175,39,0,39,214
1986,KY,284,32,0,32,316
1986,LA,944,305,0,305,1249
1986,MD,130260,74,0,74,130334
1986,MO,1235,328,0,328,1563
1986,NV,256,315,0,315,571
1986,NH,159,51,0,51,210
1986,NY,3679,246,0,246,3925
1986,ND,30,16979,0,16979,17009
1986,OH,1087,63,0,63,1150
1986,OK,281,156,0,156,437
1986,OR,446,58,0,58,504
1986,PA,1236,118,0,118,1354
1986,SC,1202,57,0,57,1259
1986,SD,86,594,0,594,680
1986,UT,801,34,0,34,835
1986,VT,18,55,0,55,73
1986,WA,976,1134,0,1134,2110
1986,WI,414,537,0,537,951
1986,DE,48,0,0,0,48
1986,ME,203,0,0,0,203
1986,MA,371,0,0,0,371
1986,MI,1720,0,0,0,1720
1986,MN,190087,0,0,0,190087
1986,MS,673,0,0,0,673
1986,MT,309,0,0,0,309
1986,NE,186,0,0,0,186
1986,NJ,645,0,0,0,645
1986,NM,135,0,0,0,135
1986,NC,148125,0,0,0,148125
1986,RI,140,0,0,0,140
1986,TN,499,0,0,0,499
1986,TX,1484,0,0,0,1484
1986,VA,652,0,0,0,652
1986,WV,146,0,0,0,146
1986,WY,40,0,0,0,40
1986,DC,0,0,0,0,0
1986,USA,671620,1239338,0,1239338,1910958
1988,AL,277,0,82,82,359
1988,AK,62,0,68,68,130
1988,AZ,173,102,74,98,271
1988,AR,112,0,113,113,225
1988,CA,3538,187,521,427,3965
1988,CO,251,0,214,214,465
1988,CT,250,18528,341,18869,19119
1988,DE,45,65,130,123,168
1988,FL,251311,7434,70,7504,258815
1988,GA,509,0,78,78,587
1988,HI,160,28,172,160,320
1988,ID,103,0,60,60,163
1988,IL,182822,0,1056,1056,183878
1988,IN,958,43,78,76,1034
1988,IA,396,0,159,159,555
1988,KS,178,0,121,121,299
1988,KY,303,0,139,139,442
1988,LA,231,0,159,159,390
1988,ME,107,25,141,134,241
1988,MD,9548,67,672,523,10071
1988,MA,298,51,211,194,492
1988,MI,1089,72,210,193,1282
1988,MN,513,105,239,217,730
1988,MS,414,212,76,195,609
1988,MO,682,44,456,382,1064
1988,MT,220,493,291,408,628
1988,NE,2254,106,75,102,2356
1988,NV,147,434,74,368,515
1988,NH,188,0,60,60,248
1988,NJ,939,197,117,189,1128
1988,NM,626,59,353,307,933
1988,NY,2662,43,263,237,2899
1988,NC,24415,0,98,98,24513
1988,ND,37,77,123,117,154
1988,OH,800,115,149,141,941
1988,OK,483,0,95,95,578
1988,OR,222508,0,378,378,222886
1988,PA,924,46,909,955,1879
1988,RI,179,178,138,169,348
1988,SC,1024,0,66,66,1090
1988,SD,36,0,267,267,303
1988,TN,439,51,97,94,533
1988,TX,1334,83,128,121,1455
1988,UT,222,44,46,45,267
1988,VT,496,41,530,433,929
1988,VA,523,37,77,75,598
1988,WA,218546,994,1605,2599,221145
1988,WV,150,53,372,321,471
1988,WI,405,392,512,421,826
1988,WY,45,17567,70,17637,17682
1988,DC,0,0,23,23,23
1988,USA,933932,47973,12556,57070,991002
1990,AL,953,75,0,75,1028
1990,AK,479,46,0,46,525
1990,AR,204,16,0,16,220
1990,CO,469,114,0,114,583
1990,DE,48,59,0,59,107
1990,GA,157440,16,0,16,157456
1990,ID,342,70,0,70,412
1990,IL,1119,52,0,52,1171
1990,IA,4540,181,0,181,4721
1990,KS,325,33,0,33,358
1990,KY,1778,408,0,408,2186
1990,LA,454,16,0,16,470
1990,ME,1154,69,0,69,1223
1990,MA,1086,118,0,118,1204
1990,MI,1021,98,0,98,1119
1990,MN,550,764,0,764,1314
1990,MS,143,16,0,16,159
1990,MT,132,40,0,40,172
1990,NE,1089,88,0,88,1177
1990,NH,477,46,0,46,523
1990,NJ,1920,635,0,635,2555
1990,NM,87,34,0,34,121
1990,NC,2972,341,0,341,3313
1990,OK,330,24,0,24,354
1990,OR,299,222,0,222,521
1990,RI,244,67,0,67,311
1990,SC,271,49,0,49,320
1990,SD,45,228,0,228,273
1990,TN,410,41,0,41,451
1990,TX,1453,69,0,69,1522
1990,VA,1679,25,0,25,1704
1990,WV,677,43,0,43,720
1990,WY,160,56,0,56,216
1990,AZ,309,0,0,0,309
1990,CA,7625,0,0,0,7625
1990,CT,1005,0,0,0,1005
1990,FL,1780,0,0,0,1780
1990,HI,118,0,0,0,118
1990,IN,2237,0,0,0,2237
1990,MD,409,0,0,0,409
1990,MO,189996,0,0,0,189996
1990,NV,121,0,0,0,121
1990,NY,3071,0,0,0,3071
1990,ND,52,0,0,0,52
1990,OH,2026,0,0,0,2026
1990,PA,1903,0,0,0,1903
1990,UT,359,0,0,0,359
1990,VT,96,0,0,0,96
1990,WA,1149,0,0,0,1149
1990,WI,762,0,0,0,762
1990,DC,0,0,0,0,0
1990,USA,397368,4159,0,4159,401527
1992,AL,2132,49,249,225,2357
1992,AK,459,109,179,166,625
1992,AZ,583,65,1162,1227,1810
1992,AR,1091,78,89,86,1177
1992,CA,414038,358,120,320,414358
1992,CO,453,181,421,357,810
1992,CT,561,1500661,263,1500924,1501485
1992,DE,125,0,202,202,327
1992,FL,4458,51,1199,1250,5708
1992,GA,4634,1659,2321133,2321133,2325767
1992,HI,63,52,142,134,197
1992,ID,139,123,118,118,257
1992,IL,1333,159,112,153,1486
1992,IN,1828,96,278,249,2077
1992,IA,4621,37,284,253,4874
1992,KS,392,49,338,296,688
1992,KY,777,58,593,474,1251
1992,LA,3401,16,383,399,3800
1992,ME,287,0,198,198,485
1992,MD,1160,37,113,108,1268
1992,MA,1013,0,86,86,1099
1992,MI,3903,0,226,226,4129
1992,MN,279075,0,139,139,279214
1992,MS,230,0,184,184,414
1992,MO,2120,241,160,222,2342
1992,MT,532,0,816,816,1348
1992,NE,967,0,92,92,1059
1992,NV,466,150,766,645,1111
1992,NH,213,699,2638,3337,3550
1992,NJ,1203,0,880,880,2083
1992,NM,229,0,193,193,422
1992,NY,140313,440,86,371,140684
1992,NC,1175,449,10452,10901,12076
1992,ND,91,79,134,127,218
1992,OH,3487,190,1277,1467,4954
1992,OK,780,78,191,177,957
1992,OR,612,305,164,287,899
1992,PA,257588,715,182,603,258191
1992,RI,69,0,88,88,157
1992,SC,943,614,424,507,1450
1992,SD,37,48,529,433,470
1992,TN,2540,0,380,380,2920
1992,TX,2131,0,536,536,2667
1992,UT,605,102,99,98,703
1992,VT,58,150,101,143,201
1992,VA,1014,0,408,408,1422
1992,WA,2353,208,141,197,2550
1992,WV,103,0,123,123,226
1992,WI,779,257,410,350,1129
1992,WY,86,0,307,307,393
1992,DC,0,0,21,21,21
1992,USA,1147250,1508563,2349809,3852616,4999866
1994,AZ,413,113,0,113,526
1994,CA,216911,1207,0,1207,218118
1994,CT,186344,161,0,161,186505
1994,DE,35,120,0,120,155
1994,FL,1718,38,0,38,1756
1994,HI,193,33,0,33,226
1994,IN,1782,42,0,42,1824
1994,ME,839,66,0,66,905
1994,MD,377,87,0,87,464
1994,MA,1064,93,0,93,1157
1994,MI,1811,180,0,180,1991
1994,MN,229234,353,0,353,229587
1994,MS,332,42,0,42,374
1994,MO,842,66,0,66,908
1994,MT,263,64,0,64,327
1994,NE,5009,167,0,167,5176
1994,NV,5119,164,0,164,5283
1994,NJ,2880,579,0,579,3459
1994,NM,136,208,0,208,344
1994,NY,3990,104,0,104,4094
1994,ND,229,100,0,100,329
1994,OH,3420,113,0,113,3533
1994,PA,153222,827,0,827,154049
1994,RI,243,54,0,54,297
1994,TN,3405,112,0,112,3517
1994,TX,3311,70,0,70,3381
1994,UT,301,39,0,39,340
1994,VT,573,167,0,167,740
1994,VA,917,729,0,729,1646
1994,WA,3165,141,0,141,3306
1994,WV,153,41,0,41,194
1994,WI,99468,90,0,90,99558
1994,WY,135,81,0,81,216
1994,AL,4391,0,0,0,4391
1994,AK,65,0,0,0,65
1994,AR,912,0,0,0,912
1994,CO,326,0,0,0,326
1994,GA,1062,0,0,0,1062
1994,ID,180,0,0,0,180
1994,IL,1439,0,0,0,1439
1994,IA,642,0,0,0,642
1994,KS,495,0,0,0,495
1994,KY,153931,0,0,0,153931
1994,LA,112,0,0,0,112
1994,NH,356,0,0,0,356
1994,NC,12454,0,0,0,12454
1994,OK,796,0,0,0,796
1994,OR,254791,0,0,0,254791
1994,SC,650,0,0,0,650
1994,SD,68,0,0,0,68
1994,DC,0,0,0,0,0
1994,USA,1360504,6451,0,6451,1366955
1996,AL,2367,240,241,223,2590
1996,AK,69,24,90,87,156
1996,AZ,4931,0,963,963,5894
1996,AR,745,320,94,295,1040
1996,CA,15337,0,125,125,15462
1996,CO,408,303,2094,2397,2805
1996,CT,1963,0,87,87,2050
1996,DE,37,72,105,102,139
1996,FL,1277,0,301,301,1578
1996,GA,1467,2220,2867,5087,6554
1996,HI,523,0,62,62,585
1996,ID,890,93,85,89,979
1996,IL,242404,103,91,101,242505
1996,IN,2255,0,308,308,2563
1996,IA,2252,342,157,301,2553
1996,KS,1222,57,87,84,1306
1996,KY,252486,128,4812,4940,257426
1996,LA,448,1700102,134,1700236,1700684
1996,ME,186,327,76,287,473
1996,MD,528,0,100,100,628
1996,MA,277221,223,47,204,277425
1996,MI,1143,86,121,116,1259
1996,MN,807,182,99,169,976
1996,MS,328,36,340,297,625
1996,MO,1371,0,269,269,1640
1996,MT,177,361,680,529,706
1996,NE,163,108,85,106,269
1996,NV,324,0,4056,4056,4380
1996,NH,785,638,163,507,1292
1996,NJ,1696,161,89,161,1857
1996,NM,260,45,228,208,468
1996,NY,247563,0,53,53,247616
1996,NC,1194,250,376,330,1524
1996,ND,136,0,247,247,383
1996,OH,2872,0,266,266,3138
1996,OK,644,96,213,195,839
1996,OR,735,468,205,396,1131
1996,PA,249368,0,178,178,249546
1996,RI,86,55,48,58,144
1996,SC,372,175,293,263,635
1996,SD,76,761,540,635,711
1996,TN,611,64,862,904,1515
1996,TX,2340,150,355,309,2649
1996,UT,640,0,75,75,715
1996,VT,70,0,71,71,141
1996,VA,428,343,1158,1501,1929
1996,WA,261150,0,128,128,261278
1996,WV,73,29,108,104,177
1996,WI,2565,0,157,157,2722
1996,WY,111,136,124,129,240
1996,DC,0,0,21,21,21
1996,USA,1587104,1708698,24534,1728817,3315921
1998,AL,372,59,0,59,431
1998,AK,56,29,0,29,85
1998,AZ,624,38,0,38,662
1998,AR,247,125,0,125,372
1998,CA,5125,162,0,162,5287
1998,CO,1167,57,0,57,1224
1998,CT,2113,48,0,48,2161
1998,FL,665,63,0,63,728
1998,GA,640,232,0,232,872
1998,HI,97,26,0,26,123
1998,ID,366,38,0,38,404
1998,IL,1440,673,0,673,2113
1998,IN,1444,54,0,54,1498
1998,IA,424,41,0,41,465
1998,KS,546,47,0,47,593
1998,KY,1174,1145414,0,1145414,1146588
1998,LA,1905,48,0,48,1953
1998,MD,361,38,0,38,399
1998,MO,452,185,0,185,637
1998,NV,539,435864,0,435864,436403
1998,NH,243,40,0,40,283
1998,NY,2588,113,0,113,2701
1998,NC,1501,435,0,435,1936
1998,ND,106,56,0,56,162
1998,OH,1191,124,0,124,1315
1998,OK,382,45,0,45,427
1998,OR,877,58,0,58,935
1998,PA,174329,59,0,59,174388
1998,SC,343,239,0,239,582
1998,SD,31,61,0,61,92
1998,UT,244,51,0,51,295
1998,VT,51,31,0,31,82
1998,WA,953,94,0,94,1047
1998,WI,860,1013,0,1013,1873
1998,DE,45,0,0,0,45
1998,ME,93,0,0,0,93
1998,MA,456,0,0,0,456
1998,MI,1110,0,0,0,1110
1998,MN,975,0,0,0,975
1998,MS,323,0,0,0,323
1998,MT,190,0,0,0,190
1998,NE,106,0,0,0,106
1998,NJ,1423,0,0,0,1423
1998,NM,523,0,0,0,523
1998,RI,73,0,0,0,73
1998,TN,445,0,0,0,445
1998,TX,1722,0,0,0,1722
1998,VA,350,0,0,0,350
1998,WV,74,0,0,0,74
1998,WY,83,0,0,0,83
1998,DC,0,0,0,0,0
1998,USA,211447,1585660,0,1585660,1797107
2000,AL,219,0,107,107,326
2000,AK,30,0,51,51,81
2000,AZ,402,22,270,242,644
2000,AR,1368,0,317,317,1685
2000,CA,9166,82,137,129,9295
2000,CO,359,0,198,198,557
2000,CT,226294,54,91,88,226382
2000,DE,43,136,123,129,172
2000,FL,213569,362,5963110,5963110,6176679
2000,GA,824,0,137,137,961
2000,HI,100,32,86,83,183
2000,ID,82,0,40,40,122
2000,IL,2060,0,134,134,2194
2000,IN,1282,45,102,98,1380
2000,IA,357,0,1353022,1353022,1353379
2000,KS,791,0,76,76,867
2000,KY,606,0,105,105,711
2000,LA,196,0,217,217,413
2000,ME,101,41,341,298,399
2000,MD,556,59,98,94,650
2000,MA,330,28,58,57,387
2000,MI,298282,1568,339,1907,300189
2000,MN,290971,311,865,913,291884
2000,MS,229,46,94,90,319
2000,MO,912,1064,565,1629,2541
2000,MT,332,569,63,459,791
2000,NE,113,988,54,1042,1155
2000,NV,267,104,525,429,696
2000,NH,315,0,2440,2440,2755
2000,NJ,300712,641,101,533,301245
2000,NM,380,67,598605,598605,598985
2000,NY,2158,134,65,127,2285
2000,NC,744,0,125,125,869
2000,ND,197,69,57,67,264
2000,OH,1082,65,524,429,1511
2000,OK,344,0,72,72,416
2000,OR,306,0,1533950,1533950,1534256
2000,PA,1600,243,432,365,1965
2000,RI,85,101,54,102,187
2000,SC,342,0,100,100,442
2000,SD,32,0,69,69,101
2000,TN,321,48,473,394,715
2000,TX,1599,48,74,72,1671
2000,UT,220,46,39,45,265
2000,VT,31,39,164,153,184
2000,VA,840,387,206,335,1175
2000,WA,1026,2461379,308,2461687,2462713
2000,WV,830,27,268,241,1071
2000,WI,1082,64,2598607,2598607,2599689
2000,WY,41,30,38,38,79
2000,DC,0,0,21,21,21
2000,USA,1364128,2468899,12058117,14523778,15887906
2002,AL,1240,84,0,84,1324
2002,AK,27,23,0,23,50
2002,AR,156,213,0,213,369
2002,CO,173233,355,0,355,173588
2002,DE,34,91,0,91,125
2002,GA,5045,246,0,246,5291
2002,ID,121,48,0,48,169
2002,IL,889,71,0,71,960
2002,IA,772,156,0,156,928
2002,KS,730,21,0,21,751
2002,KY,1263,53,0,53,1316
2002,LA,590,1450,0,1450,2040
2002,ME,509,94,0,94,603
2002,MA,399,28,0,28,427
2002,MI,683,69,0,69,752
2002,MN,497,982,0,982,1479
2002,MS,246,23,0,23,269
2002,MT,49,51,0,51,100
2002,NE,92,23,0,23,115
2002,NH,181,403,0,403,584
2002,NJ,594,164,0,164,758
2002,NM,297,52,0,52,349
2002,NC,875,191,0,191,1066
2002,OK,452,75,0,75,527
2002,OR,350,96,0,96,446
2002,RI,99,28,0,28,127
2002,SC,188,159,0,159,347
2002,SD,211,337501,0,337501,337712
2002,TN,595,164,0,164,759
2002,TX,2581,135,0,135,2716
2002,VA,369,22,0,22,391
2002,WV,134,60,0,60,194
2002,WY,65,34,0,34,99
2002,AZ,903,0,0,0,903
2002,CA,2548,0,0,0,2548
2002,CT,493,0,0,0,493
2002,FL,2552,0,0,0,2552
2002,HI,131,0,0,0,131
2002,IN,1456,0,0,0,1456
2002,MD,843,0,0,0,843
2002,MO,407,0,0,0,407
2002,NV,263,0,0,0,263
2002,NY,2207,0,0,0,2207
2002,ND,365,0,0,0,365
2002,OH,841,0,0,0,841
2002,PA,2643,0,0,0,2643
2002,UT,17328,0,0,0,17328
2002,VT,49,0,0,0,49
2002,WA,919,0,0,0,919
2002,WI,292,0,0,0,292
2002,DC,0,0,0,0,0
2002,USA,227806,343165,0,343165,570971
2004,AL,279,45,61,60,339
2004,AK,32,637,62,509,541
2004,AZ,429,28,155,146,575
2004,AR,234,136,167,156,390
2004,CA,2546,79,164,153,2699
2004,CO,1049,369,378,326,1375
2004,CT,696,46,157,147,843
2004,DE,40,0,219,219,259
2004,FL,1009,3245,349,3594,4603
2004,GA,943,89,96,92,1035
2004,HI,116,29,188,174,290
2004,ID,78,16,41,40,118
2004,IL,1416,36,157,147,1563
2004,IN,288218,64,76,74,288292
2004,IA,502,37,64614,64651,65153
2004,KS,312,38,62,60,372
2004,KY,415,2270,80,2350,2765
2004,LA,114957,73,110,105,115062
2004,ME,166,0,182,182,348
2004,MD,298,50,124,117,415
2004,MA,362,0,63,63,425
2004,MI,759,0,548,548,1307
2004,MN,620,0,537,537,1157
2004,MS,193,0,84,84,277
2004,MO,638,121,233,212,850
2004,MT,50,0,77,77,127
2004,NE,227,0,47,47,274
2004,NV,198,61,781,680,878
2004,NH,138,48,2102,2150,2288
2004,NJ,675,0,252,252,927
2004,NM,304,0,10289,10289,10593
2004,NY,75594,42,86,83,75677
2004,NC,915,387,129,335,1250
2004,ND,83,43,57,56,139
2004,OH,921,57,1039,1096,2017
2004,OK,220,140,50,134,354
2004,OR,409,50,433,366,775
2004,PA,2032,153,819,776,2808
2004,RI,85,0,76,76,161
2004,SC,229,171,93,161,390
2004,SD,224,2991,73,3064,3288
2004,TN,414,0,112,112,526
2004,TX,2103,0,69,69,2172
2004,UT,231,39,34,39,270
2004,VT,36,34,78,76,112
2004,VA,661,0,202,202,863
2004,WA,810,132,233,212,1022
2004,WV,194,0,125,125,319
2004,WI,416,144,2997007,2997007,2997423
2004,WY,119,0,39,39,158
2004,DC,0,0,20,20,20
2004,USA,503595,11900,3083229,3092289,3595884
2006,AZ,1068,166,0,166,1234
2006,CA,3153,64,0,64,3217
2006,CT,243155,163,0,163,243318
2006,DE,86,38,0,38,124
2006,FL,241377,71,0,71,241448
2006,HI,111,64,0,64,175
2006,IN,1314,21,0,21,1335
2006,ME,91,29,0,29,120
2006,MD,306,163,0,163,469
2006,MA,319,42,0,42,361
2006,MI,1508,102,0,102,1610
2006,MN,844,79,0,79,923
2006,MS,155,55,0,55,210
2006,MO,433,935,0,935,1368
2006,MT,80,6546,0,6546,6626
2006,NE,434,57,0,57,491
2006,NV,1595,111,0,111,1706
2006,NJ,2450,99,0,99,2549
2006,NM,211227,38,0,38,211265
2006,NY,4863,50,0,50,4913
2006,ND,50,40,0,40,90
2006,OH,225681,130,0,130,225811
2006,PA,253925,91,0,91,254016
2006,RI,68,238,0,238,306
2006,TN,395,732,0,732,1127
2006,TX,1766,61,0,61,1827
2006,UT,186,50,0,50,236
2006,VT,190,47,0,47,237
2006,VA,1285,2370445,0,2370445,2371730
2006,WA,1146,94,0,94,1240
2006,WV,206,29,0,29,235
2006,WI,1364,41,0,41,1405
2006,WY,196215,40,0,40,196255
2006,AL,245,0,0,0,245
2006,AK,96,0,0,0,96
2006,AR,212,0,0,0,212
2006,CO,1244,0,0,0,1244
2006,GA,146188,0,0,0,146188
2006,ID,396,0,0,0,396
2006,IL,2146,0,0,0,2146
2006,IA,1324,0,0,0,1324
2006,KS,671,0,0,0,671
2006,KY,1331,0,0,0,1331
2006,LA,488,0,0,0,488
2006,NH,1002,0,0,0,1002
2006,NC,122300,0,0,0,122300
2006,OK,249,0,0,0,249
2006,OR,336,0,0,0,336
2006,SC,412,0,0,0,412
2006,SD,39,0,0,0,39
2006,DC,0,0,0,0,0
2006,USA,1675725,2380931,0,2380931,4056656
2008,AL,288195,59,73,71,288266
2008,AK,337,2533,73,2606,2943
2008,AZ,747,0,194,194,941
2008,AR,94,27,80,77,171
2008,CA,373723,0,65,65,373788
2008,CO,486,158,183,170,656
2008,CT,9578,0,70,70,9648
2008,DE,68,53,63,61,129
2008,FL,2330,0,700,700,3030
2008,GA,625,667,333,544,1169
2008,HI,60,0,35,35,95
2008,ID,2716,67,62,66,2782
2008,IL,1323,40,63,61,1384
2008,IN,550,0,3918,3918,4468
2008,IA,397,62,171,160,557
2008,KS,574,67,107,102,676
2008,KY,615,288,98,260,875
2008,LA,93658,265,85,247,93905
2008,ME,212,69,92,88,300
2008,MD,10594,0,62,62,10656
2008,MA,328,46,61,60,388
2008,MI,1966,54,97,93,2059
2008,MN,1185,2887646,159,2887805,2888990
2008,MS,289,69,122,116,405
2008,MO,1188,0,2925205,2925205,2926393
2008,MT,49,34,939,973,1022
2008,NE,541,91,107,102,643
2008,NV,536,0,129,129,665
2008,NH,396,267,170,246,642
2008,NJ,1207,114,102,120,1327
2008,NM,338,70,105,101,439
2008,NY,2658,0,54,54,2712
2008,NC,835,195,4310851,4310851,4311686
2008,ND,66,0,191,191,257
2008,OH,14602,0,385,385,14987
2008,OK,212,91,50,95,307
2008,OR,217,562,97,470,687
2008,PA,3009,0,158,158,3167
2008,RI,74,34,56,55,129
2008,SC,898,104,183,170,1068
2008,SD,45,63,196,181,226
2008,TN,327,47,106,101,428
2008,TX,1980,135,137,130,2110
2008,UT,142,0,56,56,198
2008,VT,20,0,42,42,62
2008,VA,318038,50,269,242,318280
2008,WA,703,0,92,92,795
2008,WV,175,57,122,116,291
2008,WI,530,0,115,115,645
2008,WY,166,30,49,48,214
2008,DC,0,0,18,18,18
2008,USA,1139602,2894114,7246950,10138077,11277679
2010,AL,1264,51,0,51,1315
2010,AK,41,452,0,452,493
2010,AZ,2881,65,0,65,2946
2010,AR,406,75,0,75,481
2010,CA,6866,163,0,163,7029
2010,CO,905,1545,0,1545,2450
2010,CT,908,177,0,177,1085
2010,FL,1717,82,0,82,1799
2010,GA,1442,82,0,82,1524
2010,HI,295,29,0,29,324
2010,ID,203,34,0,34,237
2010,IN,2760,110,0,110,2870
2010,IA,1986,50,0,50,2036
2010,KS,233,36,0,36,269
2010,KY,239525,141,0,141,239666
2010,LA,278,84,0,84,362
2010,MD,441,59,0,59,500
2010,MO,1661,118,0,118,1779
2010,NV,177990,299,0,299,178289
2010,NH,1763,68,0,68,1831
2010,NY,5908,41,0,41,5949
2010,NC,12239,137,0,137,12376
2010,ND,166,29,0,29,195
2010,OH,1981,91,0,91,2072
2010,OK,252,35,0,35,287
2010,OR,669,88,0,88,757
2010,PA,4841,1108,0,1108,5949
2010,SC,526,46,0,46,572
2010,SD,961,16,0,16,977
2010,UT,469,54,0,54,523
2010,VT,48,47,0,47,95
2010,WA,2236,373,0,373,2609
2010,WI,1092,363,0,363,1455
2010,DE,101,0,0,0,101
2010,IL,204555,0,0,0,204555
2010,ME,276,0,0,0,276
2010,MA,1158,0,0,0,1158
2010,MI,2095,0,0,0,2095
2010,MN,2385,0,0,0,2385
2010,MS,562,0,0,0,562
2010,MT,59,0,0,0,59
2010,NE,140,0,0,0,140
2010,NJ,1613,0,0,0,1613
2010,NM,779,0,0,0,779
2010,RI,338,0,0,0,338
2010,TN,486,0,0,0,486
2010,TX,16376,0,0,0,16376
2010,VA,228312,0,0,0,228312
2010,WV,9884,0,0,0,9884
2010,WY,35,0,0,0,35
2010,DC,0,0,0,0,0
2010,USA,944107,6148,0,6148,950255
2012,AL,282,0,71,71,353
2012,AK,44,0,114,114,158
2012,AZ,9016,638,181,515,9531
2012,AR,289,0,66,66,355
2012,CA,6318,63,68,66,6384
2012,CO,1582,0,322,322,1904
2012,CT,850,129,92,126,976
2012,DE,51,42,85,82,133
2012,FL,333199,123,6528,6651,339850
2012,GA,708,0,212,212,920
2012,HI,209,63,37,62,271
2012,ID,101,0,49,49,150
2012,IL,298135,0,94,94,298229
2012,IN,2583,297,160,271,2854
2012,IA,622,0,295,295,917
2012,KS,196,0,73,73,269
2012,KY,696,0,69,69,765
2012,LA,274,0,92,92,366
2012,ME,157,74,106,102,259
2012,MD,353,53,60,59,412
2012,MA,3585,223,68,204,3789
2012,MI,348205,76,172,161,348366
2012,MN,3424,45,216,198,3622
2012,MS,180,96,141,133,313
2012,MO,405,101,174,163,568
2012,MT,154,495,117,409,563
2012,NE,1680,102,72,99,1779
2012,NV,552,2946,252,3198,3750
2012,NH,852,0,309,309,1161
2012,NJ,854,81,90,86,940
2012,NM,234,299,160,268,502
2012,NY,27169,38,53,52,27221
2012,NC,338004,0,1088,1088,339092
2012,ND,122,5626,81,5707,5829
2012,OH,1593,284,652,511,2104
2012,OK,274,0,47,47,321
2012,OR,346,0,133,133,479
2012,PA,1769,180,320,282,2051
2012,RI,210,53,57,56,266
2012,SC,410,0,155,155,565
2012,SD,107,0,88,88,195
2012,TN,434,45,77,75,509
2012,TX,2119,101,101,98,2217
2012,UT,245394,44,33,44,245438
2012,VT,32,34,44,43,75
2012,VA,991,289,471,393,1384
2012,WA,797,76,107,103,900
2012,WV,311,65,59,65,376
2012,WI,647,310,246,280,927
2012,WY,36,30,39,38,74
2012,DC,0,0,19,19,19
2012,USA,1636555,13121,14415,23896,1660451
2014,AL,230,17,0,17,247
2014,AK,163,1024,0,1024,1187
2014,AR,423,93,0,93,516
2014,CO,701,1169,0,1169,1870
2014,DE,70,118,0,118,188
2014,GA,616,216,0,216,832
2014,ID,121,51,0,51,172
2014,IL,2018,149,0,149,2167
2014,IA,1488,198,0,198,1686
2014,KS,256,153,0,153,409
2014,KY,282,103,0,103,385
2014,LA,292,417,0,417,709
2014,ME,404,43,0,43,447
2014,MA,543,69,0,69,612
2014,MI,1184,121,0,121,1305
2014,MN,2724,159,0,159,2883
2014,MS,148,72,0,72,220
2014,MT,106,90,0,90,196
2014,NE,639,48,0,48,687
2014,NH,678,585,0,585,1263
2014,NJ,867,119,0,119,986
2014,NM,214,146,0,146,360
2014,NC,778,1652,0,1652,2430
2014,OK,177,40,0,40,217
2014,OR,320,84,0,84,404
2014,RI,146,38,0,38,184
2014,SC,323,91,0,91,414
2014,SD,47,76,0,76,123
2014,TN,369,52,0,52,421
2014,TX,2475,58,0,58,2533
2014,VA,665,9076,0,9076,9741
2014,WV,804,57,0,57,861
2014,WY,36,29,0,29,65
2014,AZ,220133,0,0,0,220133
2014,CA,18479,0,0,0,18479
2014,CT,709,0,0,0,709
2014,FL,5000,0,0,0,5000
2014,HI,508,0,0,0,508
2014,IN,557,0,0,0,557
2014,MD,2256,0,0,0,2256
2014,MO,534,0,0,0,534
2014,NV,904,0,0,0,904
2014,NY,2774,0,0,0,2774
2014,ND,93,0,0,0,93
2014,OH,742,0,0,0,742
2014,PA,1016,0,0,0,1016
2014,UT,471,0,0,0,471
2014,VT,47,0,0,0,47
2014,WA,2310,0,0,0,2310
2014,WI,532,0,0,0,532
2014,DC,0,0,0,0,0
2014,USA,277372,16413,0,16413,293785
2016,AL,375,56,57,56,431
2016,AK,112,105,108,104,216
2016,AZ,662,124,524,429,1091
2016,AR,163,67,58,66,229
2016,CA,315165,68,52,76,315241
2016,CO,633,303,357,310,943
2016,CT,382,68,117,112,494
2016,DE,110,0,141,141,251
2016,FL,2954,217,2741,2958,5912
2016,GA,546,116,339,297,843
2016,HI,61,32,50,49,110
2016,ID,90,41,49,48,138
2016,IL,1211,106,93,102,1313
2016,IN,501,168,83,157,658
2016,IA,627,64,174,162,789
2016,KS,296,52,77,74,370
2016,KY,233,110,53,106,339
2016,LA,516,173,81,164,680
2016,ME,280,0,684,684,964
2016,MD,409,62,59,62,471
2016,MA,346,0,59,59,405
2016,MI,967,0,4799284,4799284,4800251
2016,MN,372202,0,1736,1736,373938
2016,MS,165,0,89,89,254
2016,MO,367,708,85,546,913
2016,MT,102,0,77,77,179
2016,NE,2783,0,63,63,2846
2016,NV,3010,852,858,932,3942
2016,NH,2586,739140,744296,744296,746882
2016,NJ,1095,0,113,113,1208
2016,NM,177,0,201,201,378
2016,NY,2896,40,66,65,2961
2016,NC,982,301,505,416,1398
2016,ND,34,25,44,43,77
2016,OH,744,76,204,187,931
2016,OK,191,36,43,42,233
2016,OR,392,68,148,139,531
2016,PA,1267,1928,18938,20866,22133
2016,RI,110,0,103,103,213
2016,SC,378,60,112,107,485
2016,SD,56,36,53,52,108
2016,TN,339,0,60,60,399
2016,TX,3940,0,182,182,4122
2016,UT,259,38,88,85,344
2016,VT,21,57,61,59,80
2016,VA,927,0,325,325,1252
2016,WA,865,88,101,97,962
2016,WV,174,0,37,37,211
2016,WI,377,560,12632,13192,13569
2016,WY,50,0,34,34,84
2016,DC,0,0,18,18,18
2016,USA,723128,745945,5586512,5589662,6312790
2018,AZ,969,894,0,894,1863
2018,CA,18622,198,0,198,18820
2018,CT,419,91,0,91,510
2018,DE,54,71,0,71,125
2018,FL,3671,8190005,0,8190005,8193676
2018,HI,60,37,0,37,97
2018,IN,731,290,0,290,1021
2018,ME,3974,83,0,83,4057
2018,MD,361,45,0,45,406
2018,MA,327,65,0,65,392
2018,MI,2086,260,0,260,2346
2018,MN,292988,134,0,134,293122
2018,MS,179,169,0,169,348
2018,MO,765,295,0,295,1060
2018,MT,381,523,0,523,904
2018,NE,1235,83,0,83,1318
2018,NV,524,347,0,347,871
2018,NJ,3493,145,0,145,3638
2018,NM,1360,67,0,67,1427
2018,NY,14755,47,0,47,14802
2018,ND,64,150,0,150,214
2018,OH,1861,246,0,246,2107
2018,PA,3118,125,0,125,3243
2018,RI,105,68,0,68,173
2018,TN,378,150,0,150,528
2018,TX,215372,791,0,791,216163
2018,UT,269445,49,0,49,269494
2018,VT,36,39,0,39,75
2018,VA,2949,100,0,100,3049
2018,WA,1235,94,0,94,1329
2018,WV,328,584,0,584,912
2018,WI,602,150,0,150,752
2018,WY,46,42,0,42,88
2018,AL,341,0,0,0,341
2018,AK,256,0,0,0,256
2018,AR,401,0,0,0,401
2018,CO,669,0,0,0,669
2018,GA,284977,0,0,0,284977
2018,ID,123,0,0,0,123
2018,IL,14605,0,0,0,14605
2018,IA,2045,0,0,0,2045
2018,KS,7825,0,0,0,7825
2018,KY,824,0,0,0,824
2018,LA,217,0,0,0,217
2018,NH,313,0,0,0,313
2018,NC,284116,0,0,0,284116
2018,OK,2235,0,0,0,2235
2018,OR,402,0,0,0,402
2018,SC,2500,0,0,0,2500
2018,SD,65,0,0,0,65
2018,DC,0,0,0,0,0
2018,USA,1444407,8196437,0,8196437,9640844
